WWWWWWWWWWWWWWWWWW
W----------------W
W---P---*-----G--W
W-------*--------W
W----------------W
W-------*-----*--W
WWWWWWWWWWWWWWWWWW