WWWWWWWWWWWWWWWWW
W---------------W
W----------G----W
W--------*---*--W
W--------*-C-*--W
W--------*---*--W
W--------*---*--W
W--P------------W
W---------------W
WWWWWWWWWWWWWWWWW