WWWWWWWWWWWWWWW
W-------------W
W--P----------W
W-------------W
W-------------W
W---------*---W
W-------------W
WWWWWWWWWWWWWWW
  
         
  